111111111111111111111111111111
100000000000000000000000000001
100000000030040005000000000001
100000000000000000000000000001
100000000000000000000000000001
100000000000000000000000000001
100000002020002002002000000001
100000000004000050000000000001
100000000000000000002000000001
100000200002000022220000000001
100000000000000000002000000001
100000000000000000000000000001
100000200002000002000000200001
100000000000000000000000000001
111111111111111111111111111111